++++++++++++++++++++++
++++++++++++++++++++++
S +       +   +   + ++
+ + +++++ +++ + + + ++
+ + +   +   + + +   ++
+ + + +++++ + + + ++++
+   + +     +   +   ++
+++++ + +++++ +++++ ++
+     + +   + +     ++
+ +++++ +++ + + ++++++
+   +   +     + +   ++
+++ + +++ + +++ + + ++
+         +   + + + ++
+ + +++ + +++++ + + ++
+ + +   +     +   + ++
+++ + +++ +++ +++++ ++
+   + + + + +       ++
+ +++ + + + + ++++++++
+   + +   + + +     ++
+++ + + +++ + + +++ ++
+     +     +   +     
++++++++++++++++++++++